{
    "n" :10,
    "m" :10,
    "cells":[
        ["#","#","#","#","#","#","#","#","#","#"],
        ["#"," ","#","#","#","#","#","#","#","#"],
        ["#"," "," "," ","#","#","#","#","#","#"],
        ["#","#","#"," "," ","#","#","#","#","#"],
        ["#","#","#","#"," ","#","#","#","#","#"],
        ["#","#","#","#"," ","#","#","#","#","#"],
        ["#","#","#","#"," "," "," ","#","#","#"],
        ["#","#","#","#","#","#"," ","#","#","#"],
        ["#","#","#","#","#","#"," "," "," "," "],
        ["#","#","#","#","#","#","#","#","#","#"]
    ]
}